F ./textures/starWarsFloor.xpm
SO ./textures/starWarsWall.xpm
WE ./textures/starWarsWall.xpm
EA ./textures/starWarsWall.xpm
C  ./textures/starCeiling.xpm









NO ./textures/starWarsWall.xpm

D ./textures/starWarsDoor.xpm





        1111111111111111111111111
        1000000000110000000111001
        10110000011100000001 1001
        1001000000000000000111001
111111111011000001110000000000001
10000000000100000111111111111111
11110111111111001100000000001
1111D111111111000000010000001
11000000110101D11100000000001
10000000000000001100000000001
10000000000000001101D10000001
1100000111010101111101110000111
1111N111 1110101 101111010001
11111111 1111111 111111111111