F ./textures/starWarsFloor.xpm
SO ./textures/starWarsWall.xpm
WE ./textures/starWarsWall.xpm
EA ./textures/starWarsWall.xpm
C  ./textures/starCeiling.xpm









NO ./textures/starWarsWall.xpm

D ./textures/starWarsDoor.xpm


1111111111111111111111111111111111111111111111111111111
1000000000000000000000001111110000000000000000000000001
1000000000000000000000001111110000000000000000000000001
10000000000000000000000011D1110000000000000000000000001
1000000000000000000000000000000000000000000000000000001
1111110011111111111100000000000011111111111100111111111
1111110011111111111100000000000011111111111100111111111
1000000000000000000000000000000000000000000000000000001
1000000000000000000000000000000000000000000000000000001
1111110011111100001111D11111000011111100001111110011111
1111110011111100001111D11111000011111100001111110011111
1000000000000000000000000000000000000000000000000000001
1000000000000000000000000000000000000000000000000000001
1111110011111111111100000000000011111111111100111111111
11111100111111D1111100000000000011111D11111001111111111
1000000000000000000000000000000000000000000000000000001
1000000000000000000000000000000000000000000000000000001
1111111111111111111100000000000011111111111111111111111
1000000000000000000000001111110000000000000000000000001
10000000000000000000000011D1111000000000000000000000001
1000000000000000000000000000001000000000000000000000001
111111111100111111111111000000D001111111110011111111111
1111111111001111111111110000001111111111110011111111111
1000000000000000000000000000000000000000000000000000001
100000000000000000000N000000000000000000000000000000001
1111110011111111111100001111110000111111111111001111111
1111110011111111111100001111110000111111111111001111111
1000000000000000000000000000000000000000000000000000001
1000000000000000000000000000000000000000000000000000001
1111111111111111111111111111111111111111111111111111111